TTTTTTTTTTTTTTTTTTTTTT
T             T       T
T  TTTTTTTTT  R  T    T
T  T           T TTT  T
T  T  R   TTTT T      T
T  TTT     T     TTT  T
T      TTT T R   T    T
T  TTT T         TTT  T
T  T   TTTTTTTTT T    T
T  T R            TTT T
T  TTTTT TTTTTTTT T    T
T          T      TTT  T
T    R     TTTTTT      T
TTTTTTTTTTTTTTTTTTTTTTTT